0 0 15 0 0 0 8 0 0 0 0 0 0 0 0 0 17 0 0 0 6 0 0 0
0 18 0 0 0 0 0 0 0 16 0 0 0 0 0 0 0 0 0 0 0 0 0 0
7 0 0 0 0 0 0 0 0 0 0 0 3 21 21 21 21 21 21 21 21 21 21 21 21
0 0 0 0 0 0 0 0 17 0 0 0 12 24 23 23 33 23 23 23 26 23 23 23 27
0 0 0 0 0 6 0 0 0 0 0 0 12 23 25 23 23 23 34 23 23 23 23 35 23
21 21 21 21 21 4 0 0 0 15 0 0 12 23 23 26 23 23 23 25 23 23 23 23 24
25 23 33 23 23 11 0 18 0 0 0 0 12 23 27 23 19 1 1 1 1 1 1 1 1
23 23 23 27 34 11 0 0 0 0 8 0 12 26 23 23 11 0 0 16 0 0 0 0
23 35 23 23 23 20 21 21 21 21 21 21 22 23 25 23 11 0 0 0 0 0 0 0
1 1 2 24 23 23 33 23 23 23 25 23 23 23 26 23 11 0 0 0 0 0 0 15
0 0 12 23 26 23 23 23 35 23 23 23 34 23 23 23 11 0 7 0 0 0 0 0
0 17 12 23 23 25 23 23 23 23 27 23 23 23 24 33 11 0 0 0 0 18 0 0
0 0 13 1 1 1 1 1 1 1 1 1 1 1 1 1 14 0 0 0 0 0 0 0
8 0 0 0 16 0 0 0 0 6 0 0 0 0 0 0 0 0 15 0 0 0 8 0
0 0 0 0 0 0 7 0 0 0 0 0 0 0 0 0 0 0 0 0 0 17 0 0