0 0 0 0 0 0 0 0 0 0 0 0 0 0 0 0 0 0 0 0 0 0 0 0
0 0 45 0 0 0 0 0 0 0 0 0 0 0 0 0 0 0 0 0 0 48 0 0
0 0 0 0 0 0 0 0 0 0 0 0 48 0 0 0 0 0 0 0 0 0 0 0
0 0 0 0 0 0 0 0 0 0 0 0 0 0 0 0 0 0 0 0 0 0 0 0
0 0 0 0 0 0 0 0 0 0 0 0 0 0 0 0 0 0 0 0 0 0 0 0
0 0 0 0 0 0 0 0 0 0 126 127 128 129 0 0 0 0 0 0 0 0 0 0
0 0 0 0 0 0 0 0 0 0 140 141 142 143 0 0 0 0 0 0 0 0 0 0
0 0 0 48 0 0 0 0 0 0 154 155 156 157 0 0 0 0 0 0 0 0 0 0
0 0 0 0 0 0 0 0 0 0 168 169 170 171 0 0 0 0 0 0 45 0 0 0
0 0 0 0 0 0 0 0 0 0 182 183 184 185 0 0 0 0 0 0 0 0 0 0
0 0 0 45 0 0 0 0 0 0 0 61 61 0 0 0 0 0 0 0 0 0 0 0
0 0 0 0 0 0 0 0 0 0 0 61 61 0 0 0 0 0 0 0 0 0 0 0
0 0 0 0 0 0 0 0 0 0 0 61 61 0 0 0 0 0 0 48 0 0 0 0
0 0 0 0 0 0 0 0 0 0 0 61 61 0 0 0 0 0 0 0 0 0 0 0
0 0 0 0 0 0 0 0 0 0 0 61 61 0 0 0 0 0 0 45 0 0 0 0